####################
#..................#
#...........###....#
#.....##...........#
#.....#............#
#.....#............#
#.....#........#####
#.....###..........#
####################