####################
#..................#
#...........###....#
#.....##...~~~~~~~~#
#.....#....~~~~~~~~#
#.....#....~~~~~~~~#
#.....#........#####
#.....###..........#
####################